XXXXXXXXXXXXXXXXXXXXXXXXXXXXXXXXXXXXXXX
X13232112323123132132312a1321223121323X
X11213XXXXX12322123131232131XXXXX13231X
X13212X1b1X12123213123132313X1c1X11111X
X12311XXXXX12312231231212313XXXX131232X
X111122211333221XXXXXXX132132312123132X
X2XX123211232321XXXXXXX132121213232XXXX
X12XX13211212312312133122312312232XXXXX
X312XXX213XXX12312XXXX213XXXXX313XXX13X
X3213XXXXX13XXXXX32113XXXXX321XXXXX213X
X12313231d2213213221213222123212321232X
XXXXXXXXXXXXXXXXXXXXXXXXXXXXXXXXXXXXXXX